#S#########
# #   #   #
# # # # # #
# # # # # #
# # # # # #
# # # # # #
# # # # # #
# # # # # #
# # # # # #
#   #   # #
#########E#