50
         S
 #########
 ########E
 ######## 
 ######## 
 ######## 
 ######## 
 ######## 
 ######## 
          