50
####     S
##   #####
#  #######
# ##     #
# ## ### #
# ## #E# #
#  #   # #
#  ####  #
##  ##  ##
###    ###